  ####### 
###  #### 
#  $   ## 
#@$ $   # 
## $ $  # 
 ## $ $ # 
  ## $  # 
   #### # 
    #.# ##
    #... #
    # #. #
    #... #
    ######
