    ####  
#####  ###
#        #
# #$# #$ #
# $  $   #
#.###  ###
#.# ####  
#.#       
#+#       
###       
