64
#####  
#   ## 
#@$  ##
## $  #
 ## $ #
  ##  #
   ##.#
    #.#
    #.#
    ###